1111111111111
1000000001C01
10000C0000101
1111C00110001
100C001110001
1011101P01001
1000000010E01
100C000111C01
1111111111111
