11111111111111111111111111
1000000000C000000000000001
10000C00000000000000000001
1111C001100000000000000001
100C0011100000000000000001
10111000010000000000000001
10000000101000000000000001
100C0000110000000000000001
10000C00000000000000000001
10000C00000000000000001001
10000C0000000000000001E101
10000C00000000000000010001
10111C00000000000000000001
10000C00011000000000000001
11110C11000000000000000001
1P000C01111000000000000001
11111111111111111111111111
