111111111111111
1000000000000E1
101111111111101
100C00000000101
101111111111101
100000000000001
101111111111101
100000000000001
101111111111101
100C00000000101
101111111111101
100000P00000001
101111111111101
100000000000001
111111111111111
