1111111111111111111111111
1000C0000C00000000000C001
1011111111111111111111101
100C00000000000000C000001
1001001000100100001111111
10000000000000000000000C1
1111111111111111110000111
1000000000000000000000011
1111111111001111111111111
100C011000000000000000011
1000011111111100111111111
100000000000000C000000001
1111111111111111111001111
1000000000C11000000000001
1011111111111111111111101
100C000000000000000000001
1011111111111111111111101
100000P0000000000000000E1
1111111111111111111111111
